NO textures/barrel.xpm


SO textures/barrel.xpm
WE textures/barrel.xpm

EA textures/barrel.xpm





F 220,100,0





C 25,3,0


      1111111111111111111111111    
1W00000000110000000000001
1011000001110000000000001
1001000000000000000000001
111111111011000001110000000000001
100000000011000001110111111111111
11110111111111011100000010001
11110111111111011101010010001
11000000110101011100000010001
100000000U0000001100000010001
10000000000000001101010010001
1100000111010101111101111000111
11110111 1110101 101111010000
11111111 1110111 111111111110