NO textures/barrel.xpm
SO textures/barrel.xpm
WE textures/barrel.xpm
EA textures/barrel.xpm
F 255,0,0
C 0,0,255
11111111111
100S0000001
10000000001
10000000001
10000000001
10000000001
10001010001
10001010001
10001010001
10001010001
10001010001
10000000001
10000010001
10000000001
10000010001
10000000001
10000000001
10000000011
1000000001
10000000011
10000000001
10000000001
10000000001
10000000001
10000000001
10000000001
10000000001
10000000001
10000000001
10000010101
10000000001
10000000001
10000000001
10000000001
10000000001
10000000001
111111111 