SO textures/barrel.xpm

NO textures/other.xpm
EA textures/no.xpm



F 255,100,0
C 255,30,0





1111111111111111111111111
1000000000000000000000001
1000000000000000000000001
1000000000000000000000001
1000000000000000000000001
1000000000000000000000001
1111111111111111111111111