SO textures/barrel.xpm

NO textures/other.xpm
EA textures/no.xpm


SO textures/north.xpm
F 220,100,0
F 225,30,0





1111111111111111111111111
1000000000000000000000001
1000000000000000000000001
1000000000000000000000001
1000000000000000000000001
1000000000000000000000001
1111111111111111111111111