SO textures/other.xpm

NO textures/eagle.xpm
EA textures/bluestone.xpm
WE textures/colorstone.xpm







F 173,255,47





C 173,216,230
11111111    
1001100000000001
10S01
10001000001
11111111111111111111111
