SO textures/pared.xpm

NO textures/pared.xpm
EA textures/pared.xpm
WE textures/pared.xpm







F 70,70,70





C 15,235,137
1111111111111111111111111    
1001100000000000000000001
10000S0000000000000000001
1000110000000000000000001
1111111111111111111111111
