SO textures/barrel.xpm

NO textures/other.xpm
EA textures/no.xpm
WE textures/north.xpm







F 220,120,01





C 25,3,1
1111111111111111111111111    
1000000000000000000000001
10000000000N0000000000001
1000000000000000000000001
1111111111111111111111111