SO textures/bricks.xpm

NO textures/bricks_s.xpm
EA textures/basalt_top_s.xpm
WE textures/basalt_top.xpm







F 43,104,45





C 0,170,220
1111111111111111111111111    
1001100001000000000000001
10001E0000100000000000001
1000110000010000000000001
1111111111111111111111111
