SO textures/minecraft_128/door.xpm

NO textures/minecraft_512/basalt_top_s.xpm
EA textures/minecraft_512/bricks.xpm
WE textures/minecraft_512/cracked_stone_bricks_s.xpm







F 70,70,70





C 150,235,137
1111111111111111111111111    
1001100001000000000000001
10001S0000100000000000001
1000110000010000000000001
1111111111111111111111111
