SO textures/mossy.xpm

NO textures/eagle.xpm
EA textures/colorstone.xpm
WE textures/bluestone.xpm







F 173,255,47





C 173,216,230
11111111111111111111111    
10011000000000011111011
10000N00000000000000001
10001100000000011111011
11111111111111111111111
