SO textures/mossy.xpm

NO textures/eagle.xpm
EA textures/colorstone.xpm
WE textures/bluestone.xpm







F 173,255,47





C 173,216,230
1111111111111111111111111    
1001100000000000000000001
10000W0000000000000000001
1000110000000000000000001
1111111111111111111111111
