SO textures/other.xpm

EA textures/eagle.xpm
NO textures/bluestone.xpm
WE textures/colorstone.xpm







F 173,255,47





C 173,216,230
11111111111111  
10000000000001
10N00110000001
10000000000001
11111111111111
