SO textures/other.xpm

NO textures/eagle.xpm
EA textures/bluestone.xpm
WE textures/colorstone.xpm







F 173,255,47





C 173,216,230
111111111111111   
10000000011001
10000000020001
10E00000020001
10000000020001
111111111111111
