SO textures/other.xpm

NO textures/eagle.xpm
EA textures/bluestone.xpm
WE textures/colorstone.xpm







F 173,255,47





C 173,216,230
11111111111111111111111  
10000000011000010000011
10000000020000010000011
10E00000010000011113111
10000000010000000000011
11121111111111111111111
10000001
10000001
11111111
