SO textures/other.xpm

NO textures/eagle.xpm
EA textures/bluestone.xpm
WE textures/colorstone.xpm







F 173,255,47





C 173,216,230
1111111  
1000011
1000111
10E0101
1111111 
