SO textures/bricks.xpm

NO textures/bricks_s.xpm
EA textures/basalt_top_s.xpm
WE textures/basalt_top.xpm







F 43,104,45





C 0,170,220
11111111111111111111111
10000000011000010000011
10000000020000010000011
10E00000010000011112111
10000000010000000000011
11121111111111111111111
10000001
10000001
11111111
