SO textures/barrel.xpm

NO textures/other.xpm
EA textures/no.xpm
WE textures/north.xpm







F 220,120,01





C 25,3,1

1111011111111111111111111111    
0000000000110000000000000001
000000000011000000000N000001
1000000000110000000000000001
1111111111111111111111111111