
F 43,104,45





C 0,170,220
SO textures/bricks.xpm

NO textures/bricks_s.xpm
EA textures/colorstone.xpm
WE textures/bluestone.xpm




11111111111111111111111111111111111111111111111111111111111111111111111111111
10000000000000000000000001111111111111111111111111111111111111111111111111111
10000000000000000000000001111111111111111111111111111111111111111111111111111                                          
100000000000000000000000000001111111111111111111  111111111111111111111111111
10000000000000000000000000000111111111111111111    11111111111111111111111111                                  
1000000000000000000000000000011111111111111111      1111111111111111111111111
100000000000000000000000000001111111111111111        111111111111111111111111
1000000000000000000000000000011111111111111111       111111111111111111111111
10000000000000000000000000000111111111111111111     1111111111111111111111111                                      
100000001000001000000000000001111111111111111111   11111111111111111111111111
1000000001000001000000000000000011111111111111111 111111111111111111111111111                                  
10000000001000001000000000000000001111111111111111111111111111111111111111111                                   
10000000000100000100000000000110000111111111111111111111111111111111111111111                            
10000000000010000010000000000111000001111111111111111111111111111111111111111
10000000000001000001000000000111100000111111111111111111111111111111111111111
100000000000000000000000000001  111110000011111111111111111111111111111111111
100000000000000000000000000001     111110000111111111111000000111111111111111
100000000000000000000000000001         11100011111111110001100000111111111111
100000000000000000000000000001           110001111111100001110000011111111111
100000000000000000000000000001             1000111000001111111110000011111111
100000000000010000000000000001      N      1000110000111       11000001111111
100000000000010000000000000001              100010001           1100000111111
100000000000010000000000000001              110000011            110000001111
100000000000010000000000000111111           110000011             11100000111
1000000000000100000000000000111111111111111111000000111111          100000011
10000000000001111111000000000000000000000000000000000001      111111110000111
10000000000001111111111000000000000000000000000000000001      100000000000111
10000000000001111111111000000000000000000000000000000001      100000000000111
11110000000000001111111000000000000000000000000000000001      100000111111111                              
11111000000000000001100000001111111111111111100000001111      100000111111111
1111111100000000000000000000111111111111111110000001          100000111111111
10000000000001000000000000001               10000001          100000111111111                               
10000000000001111111111000001               100000011111111111100000111111111
10000000000001111111111000001               100000000000000000000000111111111
11110000000000001111111000001               100000000000000000000000111111111
11111000000000000001100000001               111111111111111111111111111111111
11111111000000000000000000001111111111111111111111111111111111111111111111111            
11111111111000000000000000001111111111111111111111111111111111111111111111111
11111111111111111111111111111111111111111111111111111111111111111111111111111                                                