SO textures/dooro.xpm
NO textures/door4.xpm
EA textures/door3.xpm
WE textures/door2.xpm







F 70,70,70





C 150,235,137
11111111    
10000001
100N0001
10000001
11111111
