SO textures/other.xpm

NO textures/eagle.xpm
EA textures/bluestone.xpm
WE textures/colorstone.xpm







F 173,255,47





C 173,216,230
   111111111111111
      111100000011
1111111111100111111111111  
10000000000000000010000011
10000000000000000010000011
10000000E00000000000000011
1000000000000000000000011
111111111111000001111111
0000000000010000001
0000000000010000001
0000000000011111111
