NO textures/barrel.xpm
SO textures/barrel.xpm
WE textures/barrel.xpm
EA textures/barrel.xpm
F 255,0,0
C 0,0,255



11111111111111111111111111
10000000000000000000000001
100000000000000000000000011111
100000000000000000000000000001
100000000000000000000000000001
100000000000000000000000000001
100000000000000000000000000001
100000000000000000000000000001
100000000000000000000000000001
10000000100000100000000000000111111111111
100000000100000100000000000000001111111111
10000000001000001000000000000000001111111111
100000000001000001000000000001100001111111111
1000000000001000001000000000011100000111111111
100000000000010000010000000001111000001111111111
100000000000000000000000000001  11111000001111111111111111111111
100000000000000000000000000001     1111100001111111111110000001111
100000000000000000000000000001         11100011111111110001100000111
100000000000000000000000000001           11000111111110000111000001111
100000000000000000000000000001             100011100000111111111000001
100000000000010000000000000001             1000110000111       11000001
100000000000010000000000000001              100010001           1100000111
100000111000010000000000000001              110000011            1100000011
1000010N0100010000000000000111111           110000011             1110000011
1000001110000100000000000000111111111111111111000000111111          100000011
10000000000001111111000000000000000000000000000000000001      11111111000011
10000000000001111111111000000000000000000000000000000001      1000000000001
10000000000001111111111000000000000000000000000000000001      1000000000001
11110000000000001111111000000000000000000000000000000001      1000001111111
11111000000000000001100000001111111111111111100000001111      1000001
11111111000000000000000000001               10000001          1000001
10000000000001000000000000001               10000001          1000001
10000000000001111111111000001               1000000111111111111000001
10000000000001111111111000001               1000000000000000000000001
11110000000000001111111000001               1000000000000000000000001
11111000000000000001100000001               1111111111111111111111111
11111111000000000000000000001
11111111111000000000000000001
11111111111111111111111111111